#DD##################
#...................#
#...................#
#...................#
#...................#
#...................#
#...................#
#...................#
#.........1.........#
#...................#
#...................#
#...................#
#...................#
#...................#
#...........@.......#
#...................#
#####################