#D##########################################################################
#.................................#................a.......................#
#.................................#.....................................?..#
#.........................?.......#.........%.................%............#
#.........@.......................#........................................#
#.................................#.....................................?..#
############################.#########.#####################################
---------------------------#.#-------#.#
---------------------------#.#########.#
---------------------------#.....?.....#
---------------------------#############