###########################
#............@............#
#.........................#
#.........................#
#.........................#
#.........................#
#.........................#
#.........................#
#............3............#
#.........................#
#.........................#
#.........................#
#.........................#
#..^..................^...#
#.........................#
#.........................#
############DD#############