----------------#DD#
--------#########..#########
--------#.._..........._...#
--------#..................#
#######-#..................#
#.....#-#>..............<..#
#..?..###..................#
#..........................#
#########..................#
--------#................<.#
--------#..................#
--------#..................#
--------#>.................#
--------#..................#
--------#..................#
--------#................<.#-#######
--------#..................#-#.....#
--------#..................###..?..#
--------#..........................#
--------#..................#########
--------#>.................#
--------#..................#
--------#..................#
--------#................<.#
--------#..................#
--------#..................#
--------#>.................#
--------#..................#
#########..................#
#..........................#
#..?..###................<.#
#.....#-#..................#
#######-#..................#
--------#>.................#
--------#..................#
--------#..................#
--------#................<.#
--------#..................#
--------#..................#
--------#>.................#########
--------#..........................#
--------#..................###..?..#
--------#................<.#-#.....#
--------#..................#-#######
--------#..................#
--------#>.................#
--------#..................#
--------#................@.#
--------####################