######################D#
#>.....................#
#......................#
#......................#
#......................#
#.................@....#
#......................#
#......................#
#.....2................#
#......................#
#......................#
########################