############################
#..........................#
#......................@...#
#..........................#
#..........................#
#..........................#
#.....~....................#
#..........................#
#..........................#
#..........................#
#..........................#
#..........................#
#..........................#
###################.########
--------#..................#
---------#................#-
----------#..............#--
-----------#............#---
------------#..........#----
-------------#........#-----
--------------########------