############################
#.........._...............#
#.x.?.............b........#
#......,...................#
#............%.............#
#...................?......#
#....?.....................#
#.........^................#
###################.########
--------#...........>.,....#
---------#..a.............#-
----------#..............#--
-----------#......?.....#---
------------#..@.......#----
-------------#......<.#-----
--------------########------