############################
#.......................<..#
#..........................#
#..........................#
#..........................#
#..........................#
#..........................#
#..>.......................#
###################.########
........#............._....#
.........#................#.
..........#..............#..
...........#............#...
............#..........#....
.............#..^.....#.....
..............########......