############################
#..........................#
#.x.?.............b........#
#......,...................#
#..........................#
#...................?......#
#....?.....................#
#..........................#
###################.########
........#.............,....#
.........#..a.............#.
..........#..............#..
...........#......?.....#...
............#..........#....
.............#........#.....
..............########......