############################
#..........................#
#..........................#
#..........................#
#..........................#
#..........................#
#..........................#
#..........................#
###################.########
........#..................#
.........#................#.
..........#..............#..
...........#............#...
............#..........#....
.............#........#.....
..............########......