############################
#..........................#
#.x...............b........#
#......,...................#
#..........................#
#..........................#
#..........................#
#..........................#
###################.########
........#.............,....#
.........#..a.............#.
..........#..............#..
...........#............#...
............#..........#....
.............#........#.....
..............########......