############################
#.........._...............#
#.x.?.............b........#
#......,...................#
#..........................#
#...................?......#
#....?.....................#
#.........^................#
###################.########
--------#...........>.,....#
---------#..a.............#-
----------#..............#--
-----------#......?.....#---
------------#..........#----
-------------#......<.#-----
--------------########------