----------------------------------------
-######################################-
-#....................................#-
-#....................................#-
-#....................................#-
-#....................................#-
-#....................................#-
-#....................................#-
-#....................................#-
-#....................................#-
-#....................................#-
-#....................................#-
-#....................................#-
-#....................................#-
-#....................................#-
-#....................................#-
-#....................................#-
-#....................................#-
-######################################-
----------------------------------------
