-------##DD##------
-------#....#------
########....#######
#.................#
#.................#
#.?..?.......?..?.#
#.................#
#.................#
#.................#
#.................#
#.................#
#.................#
#.................#
#.................#
#.................#
#.................#
#.................#
#.................#
#.................#
#.................#
#.................#
#.................#
#.................#
#.................#
#.................#-############
#.................#-#..........#
#.................###..........#
#..............................#
#.................###..........#
#.................#-############
#.................#
#........@........#
#.................#
###################