############
#..........#
#...#..#...#
#..........#
#....##....#
#.....#....#
#....#.....#
#....##....#
#..........#
#...#..#...#
#..........#
############