##############D##############
#...........................#
#.a......................b..#
#...........................#
#...?..................?....#
#...........................#
#.............@.............#
#...........................#
#...........................#
#...?..................?....#
#...........................#
#.c......................d..#
#...........................#
#############################