#DD##################
#...................#
#...................#
#...................#
#...................#
#...................#
#...................#
#...................#
#.........0.........#
#...................#
#...................#
#...................#
#...................#
#...................#
#...........@.......#
#...................#
#####################