#####################################DD#
#......................................#
#.1....................................#
#......................................#
#......................................#
#......................................#
#......................................#
#......................................#
#....................................@.#
#......................................#
########################################