-------##DD##------
-------#....#------
########....#######
#.................#
#.................#
#.?..?.......?..?.#
#.................#
#.................#
#.................#
#.................#
#.................#
#.................#
#.................#
#.................#
#.................#
#.................#
#.................#
#.................#
#...a.............#
#.................#
#.................#
#.................#
#.........b.......#
#.................#
#.................#-############
#....x............#-#..........#
#.................###..........#
#............................<.#
#.................###..........#
#.................#-############
#.................#
#........@........#
#.................#
###################